###############
#     x@      #
#             #
#            r#
#            r#
#      b     r#
#     b2b    a#
#     bab    a#
#     bbb    a#
#     b      a#
#             #
#             #
#             #
#             #
###############
